Bonjour : Good morning
Bonsoir : Good evening
Salut   : Hello
Non     : no
Merci   : thank you
mère    : mother
père    : father
enfant  : child
grand-père : grandfather
grand-mère : grandmother
fille   : daughter
fils    : son
oncle   : uncle
tante   : aunt
nourriture : Food
boissons : drinks 
Légumes : vegetables
Cuisiner : cooking
ai faim : I’m hungry
ai soif : I’m thirsty
petit déjeuner : breakfast
déjeuner : lunch 
dîner : dinner
pantalon  : pants
tee shirt : t-shirt 
chemise   : shirt 
la veste  : jacket
la jupe   : skirt 
le pull   : sweater
robe      : dress
lundi     : Monday
mardi	  : Tuesday
mercredi  : Wednesday
jeudi     : Thursday
vendredi  : Friday
samedi    : Saturday
dimanche  : Sunday
janvier : January 
février : February 
mars    : March 
avril   : April 
mai     : May 
juin    : June 
juillet : July 
août    : August 
septembre : September 
octobre : October 
novembre : November
décembre : December
